111111111111111111111111111111111111111111
100000000000000000000000000000000000000001
1ECP10100000000000000000000000000000000001
100000100000000000000000000000000000000001
111111111111111111111111111111111111111111
